Albania = Anduin ALB
Angola = Angmar ANG
Argentina = Arthedain ARG
Belgium = Pellardur BEL
Colombia = Cardolan COL
Dominican Republic = Dale DOM
Ecuador = Erebor ECU
Egypt = Enedwaith EGY
Estonia = Entwood EST
Georgia = Gondor GEO
Guatemla = Orcs GUA
Haiti = Haradwaith HAI
Honduras = Harlindon HON
Ireland = Ithilien IRE
Israel = Isengard ISR
Jordan = Rohan JOR
Kazhastan = Khand KAZ
Lebanon = Lindon LEB
Lithuania = Lothlorien LIT
Mengukukuo = Mirkwood MEN
Mongolia = Mordor MON
Mozambique = Angmar MZB
Nepal = Northern Wastes NEP
Norway = Moria NOR
Peru = Rhun PRU
Shanxi = Shire SHX
Spain = Spiders SPR
Sweden = Swamplands SWE
Syria = Rivendell SYR
Ukraine = Umbar UKR
Uruguay = Rhudaur URG